NO ./assets/normal_north.xpm
SO ./assets/normal_south.xpm
WE ./assets/normal_west.xpm
EA ./assets/normal_east.xpm

M ./sound/imperial.mp3
F 88,88,88
C 0,0,0

 111     1      1
10001   1011  1101
1011   11S00110001
100111100010110001
100000000000000001
100011100111010001
10001 100111000001
100011000100000001
100000000000000001
100000000000000001
101110000000000001
1011 11011011000001
10001 101101111001
 1101 100000000001
  101 100001000001
  1011100000000001
  1000100000000001
  10001010011000001
 100000000000000001
  1100000000001111
   100110000001
    1000000111
     1100001
       11001
  111111000111111
 10000000000000001
10000000000000011
1010000000000001
1011100000001101 1
101100001111 1011011111111        1  1  1   1111          11
 11100001111100110000000001      1011011011100001   1    10011  1
10000000000010011011001111       10000010100011001 101   100001101
 10000000000100110000000001111111100000100000000011101111101111101
100000000000100110000111100000000000000000000010010000000000000001
 100000010101001101101  100000000110000000010000000111111100001101
1000000110100000000001111000000000000110000001000001    1000000001
 10000000000110111110000000000000000000000000000001      111110101
 100010100101101   10111000000000000000000000000001        1100001
 10000000100110111111000000000000000000000000000001       1010001
 10001110001100000000000000100001111100010000000001      1000001
 1001  101001111010100100011001111111011 1010100001     1100011
100011 10100111101010010001000000000001111001100001    100001011
100000110000000001010000000000001100000000000000001   10000000001
 10011 1001110010101000111100110110001011000001011    1000111011
  11101101  100000010101111001 110000001000110101     1000000001
    101101 10000000001000000001 10000101000010101     100001100111111
   100110111101110100000111001  10000100000000001     10011 1100000001
  11000000000000001111000000001110000000000000001     100011000000001
 101001110000000001   111100000000000011101111001     10000000011111
 1000010000000010001     10000000010001 10000001      100011111
1000000000000000001      1100000000000011001111       10001
 111111111011100001     1000010000010000001           1011
         1001100001     101101000000000011      111   101
         1001 11011    10000000101000001       1000111001
         101   1000111110000000100000001       1000000001
          1    10000000000000001000000001      101011011
               100000100110000000100100011111111000011
               1000000000000000000001000000000000111
               10000000010001101000000001011111101
                11111111 111  1 11111111 1      1
