NO ./assets/normal_north.xpm
SO ./assets/normal_north.xpm
WE ./assets/normal_north.xpm
EA ./assets/normal_north.xpm

F 149,69,53
C 8,154,255

        1111111111111111111111111
        1000000000110000000000001
        1011000001110000000000001
        1001000000000000000000001
111111111011000001110000000000001
100000000011000001112111111111111
11110111111111011100000010001
11110111111111211101010010001
11000000110101011100000010001
10000000000000001100000010001
10000000000000001101010010001
1100000111012101111101111000111
11110111 111N101 111111111111
11111111 1111111
