NO ./assets/normal_north.xpm
SO ./assets/normal_south.xpm
WE ./assets/normal_west.xpm
EA ./assets/normal_east.xpm

F 220,100,0
C 225,30,0

 111     1      1
100W1   1011  1101
1D11   11000110001
100111100010110001
1000000000^0000001
100011100111010001
10001 100111000001
100011000100000001
1000^0000000000001
100000000000000001
10111000000^000001
1D11 11D11011000001
10001 101101111001
 1101 100000000001
  1D1 100001000001
  1011100000000001
  1000100000000001
  10001010011000001
 100000000000000001
  1100000000001111
   100110000001
    1000000111
     1100001
       11D11
  111111000111111
 10000000000000001
100000000^0000011
1010^00000000001
1011100000001101 1
101100001111 1011011111111        1  1  1   1111          11
 11100001111100110000000001      1011011011100001   1    10011  1
10000000000010011011001111       10000010100011001 101   100001101
 100000000^010011000000D0011111111000001000000000111011111D1111101
1000^00000001001100001111000000000000000000^0010010D0000000^00D001
 100000010101001101101  100000000110000000010000000111111100001101
100000011010000000D001111000^00000000110000001000001    1000000001
 100000000001101111100000000000000000000^0000000001      111110101
 100010100101101   1011100000000^000000000000000001        1100001
 10000000100110111111000000000000000000000000^00001       101D111
 10001110001100000000000000100001111100010000000001      1000001
 1001  101001111010100100011001111111011 1010100001     1100011
100011 10100111101010010001000000000001111001100001    1^0001011
100000110000000001010000000000001100000D00000000001   10000000001
 10011 1001110010101000111100110110001011000001011    1000111011
  11101101  1000000101D1111001 110000001000110101     100^000001
    101101 10000000001000000001 10000101000010101     1000011D1111111
   100110111101110100000111001  10000100000000001     10011 110000^001
  1100^000000000001111000D00001110000^00000000001     1000110000F0001
 101001110000000001   111100000000000011101111001     1000D000011111
 1000010000^00010001     10000000010001 10000001      10^011111
1000000000000000001      1100000000000011001111       10001
 111111111011100001     1000010000010000001           1011
         1001100001     101101000000000011      111   1D1
         1001 11D11    10000000101000001       10^0111001
         101   1000111110000000100000001       1000000001
          1    100000000000000010000^0001      1D1D11011
               10000010011000^000100100011111111000011
               1000^0000000000000000100000D000000111
               10000000010001101000000001011111101
                11111111 111  1 11111111 1      1 
