NO ./assets/normal_north.xpm
SO ./assets/normal_south.xpm
WE ./assets/normal_west.xpm
EA ./assets/normal_east.xpm

F 150,55,3
C 0,134,171

                                                        111111
                                                        11010111111111
                11111111111111111                       11000000000001
                100000000000000011111111111111111111111111010010010011
                101000001000001000000000000000000000000000000000000001
                100000000000000011111111111111111001111111111111011111
                10001000100010001               1001           101
                10000000000000001               1001           101111111111111111
                10101010W01010101               1001           100000000000000001
                10000000000000001           111110011111       111111111111111101
                10001000100100001           100000000001                      101
                10000000000000001           100000000001                      101
                10100000100001001111111111111000100100011111111111111111111111101
                10000000000000000000000000000000000000000000000000000000000000001
                11111011111111111111111111111000100100011111111111111111111111101
                    101                     100000000001                      101
                11111011111111111           100000000001                      101
                10000000000000001           111110011111                      101
                10100000100000101               1001                          101
                10000000000000001111111111111111100111111111111111111111111111101
                10001000100010000000000000000000000000000000000000000000000000001
                10000000000000001111111111111111111111111111111111111111111111111
                10101010001010101
                10000000000000001                                                                   1111
                10001000100100001                                                                   1001
                10000000000000001                                                                   1111
                10100000100001001111111111111
                10000000000000000000000000001
                11111111111111111111111111101
                                         11011
                                        11000111111111
11111111111111111                       11000000000001
100000000000000011111111111111111111111111010010010011
101000001000001000000000000000000000000000000000000001
100000000000000011111111111111111001111111111111011111
10001000100010001               1001           101
10000000000000001               1001           101111111111111111
10101010001010101               1001           100000000000000001
10000000000000001           111110011111       111111111111111101
10001000100100001           100000000001                      101
10000000000000001           100000000001                      101
10100000100001001111111111111000100100011111111111111111111111101111111111111111111111111111111111111111111111111111111111111111111111111111111111111111111111111111111
10000000000000000000000000000000000000000000000000000000000000000000000000000000000000000000000000000000000000000000000000000000000000000000000000000000000000000000001
11111011111111111111111111111000100100011111111111111111111111101111111111111111111111111111111111111111111111111111111111111111111111111111111111111111111111111111111
    101                     100000000001                      101
11111011111111111           100000000001                      101
10000000000000001           111110011111            1         101
10100000100000101               1001                          101
10000000000000001111111111111111100111111111111111111111111111101
10001000100010000000000000000000000000000000000000000000000000001
10000000000000001111111111111111111111111111111111111111111111111
10101010001010101
10000000000000001                               1
10001000100100001                                                                           1
10000000000000001
10100000100001001                           1
10000000000000001
11111111111111111
111111                                                          1
1111                            1
111                 1
11                                          1
1
1
1
